1111111111111
1001000000001
1000000111001
1P0011E110001
10000000C1001
1C00000011001
1111111111111
