1111111111111111111111
1P00000000C0000C000001
1011111111111111110111
1010000C00000000000001
1010111111111111111101
1010000000000000000001
1011111111111111111101
1000000000000000000EC1
1111111111111111111111
