11111111111111111111111111111111
1P000000000000C00000C000000000C1
10100101000100000101010010001001
10100100101010100010001000100101
101C0100101010100010001000100101
10100100101010100010E01000100101
10100100101010100010001000100101
10100100101010100010001000100101
1C100100101010100010001000100101
11111111111111111111111111111111